


       F 41, 118, 242

 NO /home/user42/cub1d/texture/wood.xpm

R 1200 900

S /home/user42/cub1d/texture/open.xpm


           SO /home/user42/cub1d/texture/acacia_planks.xpm
WE /home/user42/cub1d/texture/wood.xpm
EA 	/home/user42/cub1d/texture/wood.xpm



   C 			  			 	215, 224, 34

55555555555555555555555555555555555555555555555555555555555555555
544444444444444444444444444444444444455655555556566666666566666665
544444444444444444444444444444444444455655555555565555555565555555
544444444444444444444444444444444444455655555556565555555565555555
544444444444444444444444444444444444455655555556566666666566666665
544444444444444444444444444444444444455655555556565555555565555555
544444444444444444444444444444444444455666666656565555555566666665
555555555555555555555555555555555555555555555555555555555555555555


111111111 11111111111111111
  10000001111000001000000001
  10020000000000001000000001
  1000000111100000100000000111111111
  11111111  100000100020000000000201
            100000100000000100000001
111111111111100011111110000100000001
120000000002000000000000000111111001
100000010000000000000000020000001001
100000010000100000000000000000001001
100000210000111100111100000002001001
1000111111111  1001  100000000000001
10001          1001  111111011111111
10001          1001       101
10001111111111110011111111101111111
10001000000000000000002000000000001
100000000000000000000000000000200W1
11111111111111111111111111111111111
