       F 220,100,0

 NO ./texture/open.xpm

R 900 600

S ./texture/open.xpm


           SO /home/user42/Bureau/cub3d/texture/redbrick.xpm
WE /home/user42/Bureau/cub3d/texture/wood.xpm
EA 	./texture/open.xpm


		 		
   C 			  			225,30,0		
		



111111111111111111111111111111111111
10000000001100000000000000001
10110000011100000020000010001
10010000000000200000000010001
10110000011100000200000010011
10000000001100000111011110001
11110111111111011100000010001
11110111111111011101010010001
11000000110101011100000010001
10002000000000001100000010001
10000000000000001101010010001
10000000S000000011010100120N1
11000000110101011111011110001
111101111111010111110111100011
1111111111111111111111111111121
100020000000000011000000100011
10000000000000001101010010001
11111111111111111111111111111