       F 220,100,0

 NO ./texture/open.xpm

R 1200 720

S ./texture/open.xpm


           SO ./texture/open.xpm
WE /home/user42/Bureau/cub3d/texture/wood.xpm
EA 	./texture/open.xpm



   C 			  			225,30,0

555555555555555555555555555555555555555555555555555555555555555555
544444444444444444444444444444444444455655555556566666666566666665
            544444444444444444444444444444444444455655555555565555555565555555
544444444444444444444444444444444444455655555556565555555565555555
544444444444444444444444444444444444455655555556566666666566666665
544444444444444444444444444444444444455655555556565555555565555555
544444444444444444444444444444444444455666666656565555555566666665
555555555555555555555555555555555555555555555555555555555555555555





111111111111111111111111111111111111
10000000001100000000000000001
10110000011100000020000010001
10010000000000200000000010001
10110000011100000200000010011
10000000001100000111011111111
1111011111111101110001
11110111111111011101011
  1100000011010101110001
11102000000000001100001111111
10000000000000001101000000001
10000000S000000011010100000N1
11000000110101011111011100001
111101111111010111110111100011
1111111111111111111111111111121
100020000000000011000000100011
10000000000000001101010010001
1111111111111111111111111111
