


       F  215, 224, 4

 NO /home/user42/cub1d/texture/wood.xpm

R 100000 90000000
S /home/user42/cub1d/texture/barrel.xpm


           SO /home/user42/cub1d/texture/wood.xpm
WE /home/user42/cub1d/texture/wood.xpm
EA /home/user42/cub1d/texture/wood.xpm


   C 			  			 	41, 118, 242


555555555555555555555555555555888555555555555555555555555555555555
544444444444444444444444444444444444455655555556566666666566666665
544444444444444444444444444444444444455655555555565555555565555555
544444444444444444444444444444444444455655555556566666666566666665
544444444444444444444444444444444444455655555556565555555565555555
544444444444444444444444444444444444455666666656565555555566666665
555555555555555555555555555555555555555555555559999999995555555555

            1111111111111111
            10000000N0000001
            1000000000000001
            1000000000000001
            1000000200000001
            1000000000000001
            1000000000000001
            1111111111111111