


       F 41, 118, 242

 NO /home/user42/cub1d/texture/wood.xpm

R 160000 90000

S /home/user42/cub1d/texture/open.xpm


           SO /home/user42/cub1d/texture/acacia_planks.xpm
WE /home/user42/cub1d/texture/wood.xpm
EA 	/home/user42/cub1d/texture/wood.xpm



   C 			  			 	215, 224, 34


55555555555555555555555555555555555555555555555555555555555555555
544444444444444444444444444444444444455655555556566666666566666665
544444444444444444444444444444444444455655555555565555555565555555
544444444444444444444444444444444444455655555556565555555565555555
544444444444444444444444444444444444455655555556566666666566666665
544444444444444444444444444444444444455655555556565555555565555555
544444444444444444444444444444444444455666666656565555555566666665
555555555555555555555555555555555555555555555555555555555555555555

            1111111111111111
            1000001000000001
            1000001002000001
            100000100000000111111111
            100000100000000100000001
111111111111100011111110000100020001
100000000000000000000000000000000001
10000200000000000200002000W000000001
100000000000100000000000000000000001
111111111000111111111100011111111111
1000000000001        100000000100001
1000002000001        100000000000001
100011111111111111111111110000111111
1000100000000000000001000000001
1000100000001000020001000000001
1000000000001000000000000000001
1111111111111111111111111111111