


       F 41, 118, 242

 NO /home/user42/cub1d/texture/wood.xpm

R 1200 400

S /home/user42/cub1d/texture/open.xpm


           SO /home/user42/cub1d/texture/acacia_planks.xpm
WE /home/user42/cub1d/texture/wood.xpm
EA 	/home/user42/cub1d/texture/wood.xpm



   C 			  			 	215, 224, 34

55555555555555555555555555555555555555555555555555555555555555555
544444444444444444444444444444444444455655555556566666666566666665
544444444444444444444444444444444444455655555555565555555565555555
544444444444444444444444444444444444455655555556565555555565555555
544444444444444444444444444444444444455655555556566666666566666665
544444444444444444444444444444444444455655555556565555555565555555
544444444444444444444444444444444444455666666656565555555566666665
555555555555555555555555555555555555555555555555555555555555555555


111111111
1111111111
1020000N11
111111111
