


       F  215, 224, 4

 NO ./texture/brick.xpm

R 1000 800
S ./texture/barrel.xpm


           SO ./texture/brick.xpm
WE ./texture/brickbrick.xpm
EA ./texture/brickbrick.xpm


   C 			  			 	41, 118, 242

55555555555555555555555555555555555555555555555555555555555555555555555555555555555
55555555555555555555555555555555555555555555555555555555555555555555555555555555555
55555555555555555555555555555555555555555555555555555555555555555555555555555555555
55555555555555555555555555555555555555555555555555555555555555555555555555555555555
54444444444444444444444444444444444444444444444444444455655555556566666666566666665
54444444444444444444444444444444444444444444444444444455655555556566666666566666665
54444444444444444444444444444444444444444444444444444455655555555565555555565555555
54444444444444444444444444444444444444444444444444444455655555555565555555565555555
54444444444444444444444444444444444444444444444444444455655555556566666666566666665
54444444444444444444444444444444444444444444444444444455655555556566666666566666665
54444444444444444444444444444444444444444444444444444455655555556565555555565555555
54444444444444444444444444444444444444444444444444444455655555556565555555565555555
54444444444444444444444444444444444444444444444444444455666666656565555555566666665
54444444444444444444444444444444444444444444444444444455666666656565555555566666665
55555555555555555555555555555555555555555555555999999999555555555555555555555555555
55555555555555555555555555555555555555555555555999999999555555555555555555555555555

7777777777777777777777777777777777
7777777788888888888888777777777777
7777777877777777777777877777777777
7777777877777777777777877777777777
7777777877777888777777877777777777
7777777877777888777777877777777777
7777777877777777777777877777777777
7777777788888888888888777777777777
7777777777777777777777777777777777

            1111111111111111
            10000000N0000001
            1000000000000001
            1000000000000001
            1000000000000001
            1000000000000001
            1111111111111111