F   94, 93, 91
NO       ./texture/wall_1.xpm
R  1280 720 
S ./texture/sprite.xpm


SO ./texture/wall_2.xpm
WE ./texture/wall_3.xpm
EA ./texture/wall_4.xpm

   C 			  			 	1, 12, 36



11111111
1000000111111
11000000000001
1E000000111111
11000001
10000001               1
10020001              101
10000001              101
1020000111111111111111101
10000000200000000000000001
1111111111111111111111111